111111111
100000001
100000001
100000N01
100000001
111111111

2, 2, 10
2, 3, 11
2, 4, 12
2, 5, 20
