111111111
100000001
100000001
100000N01
100000001
111111111

2, 2, 100
4, 2, 101
2, 4, 102
4, 4, 103
