222222222222222222222222222222222222222211111
200000000000002000000000220000000000000300001
200N00000000022200000022220000000222222200001
222222222000000000131000000000002222222222222
200000000000000000101000000000000000000000002
222222222222222222202111111111112222222222232
100010000000003000020000000000000000000000101
100030000000001000000000000000000000000010001
111111111111111111111111111111111111111111111

3.5, 12, 10
4.5, 3, 103
2.5, 42, 111
1.5, 16, 105
6.5, 3, 49
4.5, 19.5, 11
4.5, 43, 12
6.5, 40, 10
3.5, 29.5, 30
7.5, 7.5, 10
5.5, 19.5, 106
1.5, 42, 12
7, 2.25, 10
7.5, 2.5, 10
7.75, 2, 12
